+++++++++++++++++++++++++++++++++++++++++++++++++++++++++++++.
*   +     +   +       +       +     +     +             +   +.
+++ + + + + + +++ +++++ +++++ +++ + + +++ + +++++++++++ + + +.
+   + + + + + +       + +         + +   + +       +       + +.
+ +++++ + +++ + +++++ + +++++++++++ +++ + + +++++++ +++++++++.
+     + +   + +   +   +         +   +   + +   +     +       +.
+++++ + +++ + +++++ +++++++++++ + +++ +++ + + + +++++ +++++ +.
+   +   +     +   + +   +       +     +     + + +   + +   + +.
+ + +++++ +++++ + + + + + +++++++++++++ +++++++ +++ + + + + +.
+ + +   + +   + +   + + + +   +         +       +   + + +   +.
+ +++ + + + + + +++++ + + + + + + +++++++ +++++++ +++ + +++++.
+ +   +     +     + + +   + + + +   +   +       + +   + +   +.
+ + +++++ +++++ + + + +++++++ + +++ + +++++++++ + + +++ +++ +.
+ +   +     + + + +   +     + +   + + +         + + +     + +.
+ +++ +++++ + + + + +++ +++ + +++ + + + +++++++++ + + + + + +.
+     +     +   + +     +   + +   +   +   +     + + + + +   +.
+++++ + +++++++++ + +++++ + + +++++++ + + + +++ + + + +++++++.
+   + + +   +   +   +   + + +   +   + + +   + +   + + +     +.
+ + +++ + +++ + +++++ + + + +++ + +++ + +++++ + +++ + + + +++.
+ +     +     +       +   +     +     +     +       +   +   %.
+++++++++++++++++++++++++++++++++++++++++++++++++++++++++++++